               NO             ./tex/north.xpm          
SO            ./tex/south.xpm

           WE ./tex/west.xpm
EA           ./tex/east.xpm               

               F 220,100,0               

C    225,30,0


          1111111
         100000001
         100000001
 1111111110000000111111111
100000000000000000000000001
100000000000111000000000001
1000000000001 1000000000001
100000000000111000000000001
100000000000000000000000001
 1111111110000000111111111
         100000001
         1000N0001
          1111111