               NO             ./tex/north.xpm          
SO            ./tex/south.xpm

           WE ./tex/west.xpm
EA           ./tex/east.xpm               

               F 220,100,0               

C    225,30,0

1111111111111111111111111
1000000000110000000000001
1011000001110000000000001
1001000000000000N00000001
1111111111111111111111111