               NO             ./tex/north.xpm
SO            ./tex/south.xpm

           WE ./tex/west.xpm
EA           ./tex/east.xpm

               F            220,100,0
C    225,30,0


         111111111
         100000001
         100000001
111111111100000001111111111
100000000000000000000000001
100000000000000000000000001
10000N000000000000000000001
100000000000000000000000001
100000000000000000000000001
111111111100000001111111111
         100000001
         100000001
         111111111